111111111111111111111111111111111111
100000000000000000000000000000000001
10000000001111111111C111100000000001
1000C0000100000000000001100000000001
1000000010000000000000000100000000P1
100000011111111111111111000000000001
100000000000000100000000000000000001
10000000C00000010000000000C0000000E1
100000000000000000000000000000000001
111111111111111111111111111111111111
