111111111111111111111111111
1000000000C0000000000000001
100000000000000000000000001
100000000000000011000000001
100100000000C00000000000001
10000000001C100000000000001
10E100000000C00000000000001
110C00000000000000000000001
100C000000000000P1111111111
111111111111111111111111111