111111111111111111
1000000000C0000001
100000000000000001
111111111111111111
10000000001C100001
100000000000000001
10E000000000000001
100000000000000001
100C000000000000P1
111111111111111111
