111111111111111111111111
111111111111000000000111
111111111111111000000C11
100000000000000000001C11
10C00000000000E000001CP1
111111111111111111111111
111111111111111111111111
111111111111111111111111
111111111111111111111111
111111111111111111111111
100001111111111111111111
110001111111111111111111
111111111111111111111111