111111111111111111
1000000000C0000001
100000000000000001
101111111111111111
10000000001C100001
101100000000000001
10E100000000C00001
1110000C0000000001
100C000000000000P1
111111111111111111
