NO ./path_to_the_north_texture
SO ./path_to_the_south_texture
WE ./path_to_the_west_texture
EA ./path_to_the_east_texture
F 10,100,0
C 15,30,0

11111111111111111111111111111111111111111111111111111111111111111111111
10000000000000000000000000000000000000000000000000000000000000000000001
10000000000000000000000000000000000000001000000000000010000000000000001
10000000110000000000001000000000100000100000010001000000000000000000001
10000000000100000001000000000000000000000000000010100000000001000000001
10000010000000011000000000011000000010000100010000000000000000000000001
10000000000000000001000000000000000000010000000000000000100000100000001
10000010001000000000000100000000010000000000100000000000000000100000001
10000000000001000000000010000000000000000000000001010000010000001000101
10000000100000010000000000000100000000001000000000100000000000000000001
10000000110000000000000100000000000110000010000010010110010000000100101
10000000000010000000000000000000000000000000000000000000100000000000001
10000001010000000000000000000000000000000000010000000000000000000000001
10000001001100000000000110000000100100001000001000000100000100010000001
10000000001001000100000000000100000000000000000000000001001001010000001
10000000010000010000000000000000000000000000000000001000000000000010001
10001000000000000000000000000000000100001000000000000000000010100000001
1000001000000000000100000000000000000E000100000000000010001000000000001
10000000000001000000000010000000000000000000010000000000001000000100001
10000000100000000100000000000001010000000000010001001010000100000000001
10000000001000011000001000000100000100001000000000000000110000000000001
10000000101000000100000000000000000000000000000000000000001000001000101
10001000011000001000000000000000010000000100000000000000101000000000001
10000100010000101000010100100000000000000000000000010000000000000100001
10001100000000000001000000001000000001000000000010000010000000000100001
10000000101000011000000101000100000000000101000000000001000000000000001
10010100000000000000010000000000001000010000000100000000000010000100001
10000000000001010001011010011000010011000000010000000010010000000000001
10000010100000000010000100000001000000000000000000001000000000000000001
10000000000010010000000000111000010000010010000000000100000000110000001
10000010000010100100000100100000100001000101101001001001001001010000001
10000100000000000000000000100000000100000010000000000100000100010000001
11111111111111111111111111111111111111111111111111111111111111111111111